#Dimension W H
6 6
# Map tiles
#   0 : plain
#   1 : horizontal road
#   2 : vertical road
#   3 : top-left
#   4 : top-right
#   5 : bottom-left
#   6 : bottom-right
#   7 : blue house top
0-0-0-0 1-0-0-0 0-0-0-0 0-0-0-0 0-0-0-0 0-0-0-0 
0-1-0-0 0-1-2-8 0-5-0-0 0-0-0-0 0-0-0-0 0-0-0-0 
0-6-0-0 0-1-1-2 0-3-0-0 0-0-0-0 0-0-0-0 0-0-0-0 
0-4-0-0 0-1-0-0 0-1-1-0 0-5-0-0 0-0-0-0 0-0-0-0 
0-0-0-0 0-0-0-0 0-0-0-0 0-2-1-4 0-0-0-0 0-0-0-0 
0-0-0-0 0-0-0-0 0-0-0-0 0-4-0-0 0-1-0-0 0-1-0-0 
